# Who's Who: Quickname and Full Name
##### Generated: 2012-07-11 10:41:10.130844

abramovic : Marina Abramovic
abramovicandulay : Marina Abramovic and Ulay
adams : Eddie Adams
ader : Bas Jan Ader
al-karim : Halim Al-karim
alexander : Jane Alexander
ali : Laylah Ali
alsoudani : Ahmed Alsoudani
amano : Takashi Amano
anatsui : El Anatsui
andre : Carl Andre
anselmo : Giovanni Anselmo
antin : Eleanor Antin
aoshima : Chiho Aoshima
arneson : Robert Arneson
aycock : Alice Aycock
baer : Jo Baer
balincourt : Jules Balincourt
banksy : Banksy
barney : Matthew Barney
baselitz : Georg Baselitz
basquiat : Jean-Michel Basquiat
bearden : Romare Bearden
becher : Bernd and Hilla Becher
benglis : Lynda Benglis
benton : Thomas Heart Benton
beuys : Joseph Beuys
bleckner : Ross Bleckner
boetti : Aligiero Boetti
bouju : Jean-Marc Bouju
brancusi : Constantin Brancusi
bruceHighQualityfoundation : Bruce high quality foundation
brus : Günter Brus
bul : Lee Bul
burtynsky : Edward Burtynsky
cai : Cai Guo-Qiang
calder : Alexander Calder
calle : Sophie Calle
carjat : Étienne Carjat
caro : Anthony Caro
celmins : Vija Celmins
cerny : David Cerny
cezanne : Paul Cezanne
charles : Michael Ray Charles
chicago : Judy Chicago
china : China
christo : Christo and Jean Claude
close : Chuck Close
colescott : Robert Colescott
cox : Renee Cox
crewdson : Gregory Crewdson
crumb : Robert Crumb
currin : John Currin
daguerre : Jacque Daguerre
davidjl : Jacques-Louis David
davis : Ian Davis
dekooning : Willem Dekooning
delacroix : Eugène Delacroix
demand : Thomas Demand
demaria : Walter De maria
diebenkorn : Richard  Diebenkorn
disuvero : Mark di Suvero
dix : Otto Dix
duchampvillon : Raymond Duchamp-Villon
dzama : Marcel Dzama
eggleston : William Eggleston
egypt : Egypt
elaisson : Olafur Eliasson
emin : Tracy Emin
ensor : James Ensor
ernst : Max Ernst
essenhigh : Inka Essenhigh
fischiliWeiss : Fischili and Weiss
fischl : Eric Fischl
flavin : Dan Flavin
frankenthaler : Helen Frankenthaler
friedman : Tom Friedman
friedrich : Caspar David Friedrich
fritsch : Katharina Fritsch
gaylord : Jim Gaylord
geesbend : Gees Bend Quilting Community
gelatin : Gelatin
ghadirian : Shadi Ghadirian
goldsworthy : Andy Goldsworthy
gonzales-Torres : Felix Gonzales-Torres
gorky : Arshile Gorky
gottlieb : Adolf Gottlieb
goya : Francisco Goya
greco : El Greco
greek : Greek
greenberg : Clement Greenberg
grosz : George Grosz
grunewald : Matthias Grünewald
guangyi : Wang Guangyi
guerrilla : Guerrilla Girls
gupta : Subodh Gupta
gursky : Andreas Gursky
guston : Philip Guston
haacke : Hans Haacke
haerizadeh : Ramin Haerizadeh
halley : Peter Halley
hamilton : Richard Hamilton
hammons : David Hammons
hanson : Duane Hanson
haring : Keith Haring
hatoum : Mona Hatoum
hawkinson : Tim Hawkinson
heilmann : Mary Heilmann
heizer : Michael Heizer
herrera : Arturo Herrera
hesse : Eva Hesse
hirst : Damien Hirst
hockney : David Hockney
hofmann : Hans Hofmann
holt : Nancy Holt
holzer : Jenny Holzer
horn : Roni Horn
hourani : Wafa Hourani
hsieh : Tehching Hsieh
huan : Zhang Huan
huang : Huang Yong Ping
iglesias : Christina Iglesias
ingres : Jean-Auguste-Dominique Ingres
irwin : Robert Irwin
jacqueslouisdavid : Jacques-Louis David
johns : Jasper Johns
judd : Donald Judd
kahraman : Hayv Kahraman
kapoor : Anish Kapoor
katz : Alex Katz
keinholtz : Edward Keinholtz
kelly : Ellsworth Kelly
kentridge : William Kentridge
khaldi : Jeffar Khaldi
kiefer : Anselm Kiefer
kippenberger : Martin Kippenberger
klein : Yves Klein
kline : Franz Kline
kokoschka : Oskar Kokoschka
kollwitz : Käthe Kollwitz
komarmelamid : Komar and Melamid
koons : Jeff Koons
krasner : Lee Krasner
kruger : Barbara Kruger
krushenick : Nicholas Krushenick
kurland : Justine Kurland
kusama : Yayoi Kusama
lakra : Dr. Lakra
lasker : Jonathan Lasker
lawrence : Jacob Lawrence
lee : Niki S Lee
leonardodavinci : Leonardo Da Vinci
leutze : Emanuel Gottlieb Leutze
lewitt : Sol LeWitt
lichtenstein : Roy Lichtenstein
lijun : Fang Lijun
long : Richard Long
longo : Robert Longo
louis : Morris Louis
lucas : Sarah Lucas
madani : Tala Madani
manet : Édouard Manet
mangold : Robert Mangold
mapplethorp : Robert Mapplethorp
marc : Franz Marc
marden : Brice Marden
marshall : Kerry James Marshall
martin : Agnes Martin
massoudy : Hassan Massoudy
mattaclark : Gordon Matta Clark
mattes : Eva and Franco Mattes aka 0100101110101101.ORG
max : Max Ernst
mcmurdo : Wendy McMurdo
meese : Jonathan Meese
mendieta : Ana Mendieta
merz : Mario Merz
messager : Annette Messager
michelangelo : Michelangelo
millet : Jean-François Millet
mitchell : Joan Mitchell
mondrian : Piet Mondrian
monet : Claude Monet
moorer : Eelko Moorer
morley : Malcolm Morley
morris : Robert Morris
motherwell : Robert Motherwell
mr : Mr.
mrandcer : Mr and Cer
mrbrainwash : Mr. Brainwash
mueck : Ron Mueck
muehl : Otto Muehl
munch : Edvard Munch
muniz : Vic Muniz
munoz : Juan Muñoz
murakami : Takashi Murakami
nauman : Bruce Nauman
nes : Adi Nes
neto : Ernesto Neto
nevelson : Louise Nevelson
newman : Barnet Newman
niepce : Joseph Nicéphore Niépce
nitsch : Hermann Nitsch
noland : Kenneth Noland
nolde : Emil Nolde
ofili : Chris Ofili
oldenburg : Claes Oldenburg
orimoto : Tatsumi Orimoto
orozco : Gabriel Orozco
parker : Erik Parker
parks : Gordon Parks
pettibon : Raymond Pettibon
phalle : Niki de Saint Phalle
picasso : Pablo Picasso
pistoletto : Michelangelo Pistoletto
polke : Sigmar Polke
pollock : Jackson Pollock
poons : Larry Poons
popartists : Pop artists
popova : Lyubov Popova
post : Liza May Post
poussin : Nicolas Poussin
prehistory : Prehistoric Artwork
prince : Richard Prince
probst : Barbara Probst
quinn : Marc Quinn
raeburn : Sir Henry Raeburn
rauschenberg : Robert Rauschenberg
rechmaoui : Marwan Rechmaoui
reinhardt : Ad Reinhardt
richter : Gerhard Richter
riley : Bridget Riley
ringgold : Faith Ringgold
rockman : Alexis Rockman
rosenquist : James Rosenquist
rothko : Mark Rothko
ruscha : Ed Ruscha
ryman : Robert Ryman
saar : Betye Saar
sachs : Tom Sachs
salle : David Salle
schapiro : Miriam Schapiro
scharf : Kenny Scharf
schiele : Egon Schiele
schnabel : Julian Schnabel
schneemann : Carolee Schneemann
schwarzkogler : Rudolf Schwarzkogler
scully : Sean Scully
segal : George Segal
sengl : Deborah Sengl
serra : Richard Serra
serrano : Adreas Serrano
shanzhuan : Wu Shanzhaun 
sherman : Cindy Sherman
shonibare : Yinka Shonibare
smith : Tony Smith
smithson : Robert Smithson
soth : Alec Soth
southworth : Albert Southworth
spero : Nancy Spero
steinbeck : Haim Steinbach
stella : Frank Stella
still : Clifford Still
sugimoto : Hiroshi Sugimoto
taaffe : Philip Taaffe
tagra : Thukral & Tagra
tapies : Antoni Tàpies
thiebaud : Wayne Thiebaud
tiepolo : Giovanni Battista Tiepolo
tiravanija : Rirkrit  Tiravanija
tobey : Mark Tobey
traylor : Bill Traylor
truitt : Anne Truitt
tse : Shirley Tse
tsengkwongchi : Tseng Kwong Chi
turrell : James Turrell
tuttle : Richard Tuttle
twombly : Cy Twombly
uccello : Paolo Uccello
vaneyck : Jan van Eyck
vangogh : Vincent Willem van Gogh
vasarely : Victor Vasarely
verspronk : Johannes Cornelisz Verspronck
vicente : Esteban Vicente
violette : Banks Violette
walker : Kara Walker
warhol : Andy Warhol
weams : Carrie Mae Weams
wearing : Gillian Wearing
weems : Carrie Mae Weems
wesley : John Wesley
wesselmann : Tom Wesselmann
wesselmannEtal : Picture of Pop Artists
white : Charlie White
wiene : Robert Wiene
wiley : Kehende Wiley
wilke : Hannah Wilke
williams : Sue Williams
wilson : Fred Wilson
winsor : Jackie Winsor
wojnarowicz : David Wojnarowicz
womanhouse : Womanhouse
wurm : Erwin Wurm
xu : Xu Bing
yue : Yue Minjun
yuskavage : Lisa Yuskavage
zorn : John Zorn

##### end generated log
##### total items = 306

